1111111111111
1111111111111
1001000000001
1000011111001
1100110000001
1000000111111
1010000110001
1111000000011
10010000E0001
1000011111001
1100110000001
1000000111111
100C000000001
1111111100011
1000011111001
1100110000001
1P00000111111
1000000000001
1111111111111
1010101010101
1111111111111