11111111111111111111111111
10000001000011000010000001
100000100001C0100001000001
10000010000100100001000001
10000111001000010011100001
10000010000100100001000001
10000111000100100011100001
1000001C0110000110C1000001
1000000000000000000000E001
10000010011000011001000001
100000100C010010C001000001
10000100000100100000100001
10000100001000010000100001
10001100000100100000110001
1001010000010C100000101001
10100000000011000000000101
10100000000000000000000101
10100000000011000000000101
1001000000100P010000001001
10001110000011000001110001
11111111111111111111111111
