1111111111111
1001000000001
1000011111001
1100110000001
1000000111111
1010000110C01
1111000000101
100100P000C01
1000011111001
1100110000001
1000000111111
1000C00000011
111111110E011
1000011111001
1100110000001
1010010111111
1000010001001
1111111111111