1111111111111
1001000000001
1000011111001
1100110000001
1000000111111
1010000110001
11110000C0101
1001000000001
1000011111001
1100110000001
1000000111111
10000000P0011
1111111111111