1111111111111
1001000000001
1000011111001
1100110000001
1000000111111
1010000110001
11110000C0101
1001000000001
1000011111001
1100110000001
1000000111111
10000000P0011
11100011C0011
11100011C0011
11100011C0011
1000011111001
110011000C001
1010010111111
10100100010E1
1111111111111