1111111111111
1001000000001
1000011111001
1100110000001
1000000111111
1000000000001
1111000000011
1001000000001
1000011111001
1100110000001
1000000111111
1000000000001
1111111100011
1000011111001
1100110000001
1000000111111
1000000000001
1111111111111