1111111111111
1001000000001
1000011111001
1100110000001
1000000111111
1010000110001
1111000000101
1001000000001
1000011111001
1100110000001
1000000111111
100E0000P0011
1110001100011
1000011111001
110011000C001
1010010111111
1010010001001
1111111111111