1111111111111111111111111111111111
1000100000000000000000000000000001
1011100111100000101111000001110001
1010000000000000000000000000010101
1000000000100000000000000000011101
1000000000100000000000000000000001
1010010010101010000000000000001111
1011110000100000000000000000000001
1000110111111111100000000000000001
1001100000000000111000000000000001
1010010000000000000000000000010101
1000000000000000111111000000000001
1000000000000000000000000000000001
1000000000000000000000000000000001
1010010011111010000000000000011101
1010000000000000000000000000000001
1010000000000011100000000000010101
1000000000000000000000000000000001
1000000000111111110000000000000001
1000000000001000000000000000000001
1011011000111110000000000000010101
1000000000000000000000000000000001
1000000000000000000000000000000001
1000000000000000000000000000000001
1111111111111111111111111111111111