11111111111111111111111111111111
10000000000010001000000000000001
10111111111101111111111011110111
10010000000000000000000000000001
10110111111111111111111111110111
10000000000000010000000000000001
11101111111111111111111111111111
10000000000001000000000000000001
10111111111111011111111111111001
10000000000000000000000000000001
10111111111111111111111111110111
10000000000000000000000000000001
10110111111111111111111111110101
10000000000000000000000000000001
10111111111111111111111111111111
10000000000001000000000000000001
11111111111111111111111111111111
10000000000000000000000000000001
10011111111111111111111111111101
10000000000000000000000000000001
10111111111111111111111111110101
10000000000000000000000000000001
10111111111111011111111111111111
10000000000000000000000000000001
11111111111111111111111111111111
