1111111111111
10C0P0E11111111
111111111111
